1111111111111111111111111111111111
1000000000000000000000000111100001
100P0111111111110000000000C0101001
1000000000110000000000001111001011
1000000000011000000000001000001011
1000000000001000000000001000111001
1000000000001111000000001000100001
1000000000000000000000001111100001
100000000C000000000000000000000001
1000000000000000000000000000000001
1000011111111111000000000000000001
1000000000000001000000000000000001
1000000000000001000C00000000000001
1000000000000001000000000000000001
1000000000000001000000000000000001
10000000000000011111111111000C0001
1000000000000000000000000000000001
1000000C00000000000000000000000E01
1000000000000000000000000000000001
1111111111111111111111111111111111